ufk: out
kgy: srg try
fhi: mxe
ywm: tsx jqk tco
hjp: pxg fkj ode
tzd: orq joq smr
gmu: qfj
kow: tsx jqk
lga: ldk kcm eyu
trj: nnb gek
uqc: fdh rdj
opa: uwc iet cst hnj ybf
xtf: yso rzi tew
exk: wgb jyz zri igi
ice: rhu
fpv: wcy wnm
wuh: iet uwc ybf hnj
hon: vbl rnk met ihp
jvj: gqx
lgn: out
zzi: aef ecv
sce: ixo unv
uxr: iut
nss: qbk ncd
qjk: out
vjv: you rhu jny
fwg: tco
ffk: rpq txp vug hfz
djh: fdh
ekp: sau gbi
amf: ecv kjy
ciy: lgn fzm
uiv: lpi xgf
ihp: cui oul tsz
qxa: jny rhu you
xhl: vyp yoy
tdm: fcw gzu
avz: omy
qfj: kuh anb gxw ulx
rlu: ldg jee qpe riq
adu: lvz eda uiv
ykx: yfk
htw: kgs rpq vug hfz
qqf: jyz igi sdo
nkj: out
cxl: zhi okh
cui: wrc wnm
wrg: kgs txp hfz
upv: nnb
naw: zlb pav erz zxj oam
vug: fdj
yol: fek dvn ywj zxd osu
xgf: ucd
wnk: jny
gfz: ikw qjy
clh: osz
jbw: swf czw
pmi: ybs tkt cld
qqr: zme bol
yqo: tfg
qrz: iet uwc ybf hnj
eda: kek xgf
yfm: tzd szb
enl: jny
efg: ety dro onk
ipq: cwu rpf eru gmo
pgw: ekp hza mog rqt
gar: dds ihv
clx: lvd mir ezh ugd rjt
kek: ltl xph
pob: jet woy
vpy: fox rvu
ddd: kvn fmj uxr
pwe: ccy cys
hzl: wcy wrc
tfl: zxd fek ywj dvn
urb: tgo
fzn: uah jyp zvf
wzs: ksm cka
pbi: pxq fec dat
gzl: fdh
vbl: cui tcg fhi
yba: xuf exk
beo: qyj rhp jiq gfz wcx
xee: upv mxh trj
mfj: bvq uno daq qth wgz
zmk: awn ala
ldk: out
wvv: pav syo hon clb vhq eji oio lav sdy zlb yby quj kgy
rjt: oaf ttk apr
efw: kjy aef ecv
lmp: jny
blv: juh udg
gnn: fiw teb
cil: mmb wxs ymh
pfg: rvu utq
tjq: auf
dat: vgr ggt uco
jnv: htw ozg
fui: qhj
